⣿⣿⣿⣿⣿⣿⣿⣿⣿⣿⣿⣿⣿⣿⣿⣿⣿⣿⣿⣿⣿⣿⣿⣿⣿⣿⣿⣿⣿⣿⣿⣿⣿⣿⣿⣿⣿⣿⣿⣿⣿⣿⣿⣿⣿⣿⣿⣿⣿⣿
⣿⣿⣿⣿⣿⣿⣿⣿⣿⣿⣿⣿⣿⣿⣿⣿⣿⣿⣿⣿⣿⣿⣿⣿⣿⣿⣿⣿⣿⠋⠋⠋⠋⠋⠉⠀⠀⠀⠀⠉⠋⢿⣿⣿⣿⣿⣿⣿⣿⣿
⣿⣿⠏⠉⠁⠉⠉⠉⠉⠉⠉⠉⠁⠀⠀⠉⠉⢟⢿⠏⠀⠀⠀⠀⠀⢟⢿⢿⠏⠀⠀⠀⠀⠀⠀⠀⠀⠀⠀⠀⠀⠀⠀⠀⢟⢿⢿⢿⣿⣿
⣿⣿⠀⠀⠀⠀⣠⣤⣤⣄⣠⣤⣤⣄⠀⠀⠀⠀⠀⠀⠀⠀⠀⠀⠀⠀⠀⠀⠀⠀⠀⠀⠀⠀⠀⠀⠀⠀⠀⠀⠀⠀⠀⠀⠀⢀⣾⣿⣿⣿
⣿⣿⠀⠀⠀⢀⣿⣿⣿⣿⣿⣿⣿⣿⣖⠀⠀⠀⠀⠀⠀⠀⠀⠀⠀⠀⠀⠀⠀⠀⠀⠀⠀⠀⠀⠀⠀⠀⠀⠀⠀⠀⠀⢠⣾⣿⣿⣿⣿⣿
⣿⣿⠀⠀⠀⠀⢈⣿⣿⣿⣿⣿⣿⣿⣿⣦⣦⣀⣀⣀⢀⠀⠀⠀⠀⠀⠀⠀⠀⠀⠀⠀⠀⠀⠀⠀⠀⠀⠀⢀⣦⣶⣶⣿⣿⣿⣿⣿⣿⣿
⣿⣿⣄⠀⠀⠀⠀⠀⢿⣿⣿⣿⣿⣿⣿⣿⣿⣿⣿⣿⣿⣷⣷⣦⣤⣦⣷⣷⣦⠀⢀⣠⣠⣀⠀⠀⠀⠀⢀⣿⣿⣿⣿⣿⣿⣿⣿⣿⣿⣿
⣿⣿⣿⠀⠀⠀⠀⠀⠀⠉⢻⣿⣿⣿⣿⣿⣿⣿⣿⣿⣿⣿⣿⣿⣿⣿⣿⣿⣿⣿⣿⣿⣿⣿⣿⣿⣧⣄⠀⠉⠉⢉⣿⣿⣿⣿⢿⢿⣿⣿
⣿⣿⣿⣄⠀⠀⠀⠀⠀⠀⠀⠈⠏⢿⣿⣿⣿⣿⣿⣿⣿⣿⣿⣿⣿⣿⣿⣿⣿⣿⣿⣿⣿⣿⣿⣿⣿⣿⣷⣄⠀⠀⢿⣿⣿⣧⢰⣿⣿⣿
⣿⣿⣿⣿⣖⠀⠀⠀⠀⠀⠀⠀⠀⠀⠋⠛⣿⣿⣿⣿⣿⣿⣿⣿⣿⣿⣿⣿⣿⣿⣿⣿⣿⣿⣿⣿⣿⣿⣿⣿⠀⢨⣿⣿⣿⣿⢸⣿⣿⣿
⣿⣿⣿⣿⣿⣷⣦⢀⠀⠀⠀⠀⠀⠀⠀⠀⠀⠀⠀⠋⠋⠋⠋⠋⠋⠋⠋⠋⢿⣿⣿⣿⣿⣿⣿⣿⣿⣿⣿⣿⠀⠀⠋⠋⠋⠀⢨⣿⣿⣿
⣿⣿⣿⣿⣿⣿⣿⣿⣄⠀⠀⠀⠀⠀⠀⠀⠀⠀⠀⠀⠀⠀⠀⠀⠀⠀⠀⠀⠀⠀⠀⠉⠋⠋⢿⣿⣿⣿⣿⣿⣄⠀⠀⠀⠀⠀⠈⢿⣿⣿
⣿⣿⣿⣿⣿⣿⣿⣿⣿⣧⣄⠀⠀⠀⠀⠀⠀⠀⠀⠀⠀⠀⠀⠀⠀⠀⠀⠀⠀⠀⠀⠀⠀⠀⠀⢻⣿⣿⣿⣿⣿⠀⠀⠀⠀⠀⣠⣬⣿⣿
⣿⣿⣿⣿⣿⣿⣿⣿⣿⣿⣿⣄⠀⠀⠀⠀⠀⠀⠀⠀⠀⠀⠀⠀⠀⠀⠀⠀⠀⠀⠀⠀⠀⠀⠀⠀⢻⣿⣿⣿⣿⠀⠀⠀⠀⢠⣿⣿⣿⣿
⣿⣿⣿⣿⣿⣿⣿⣿⣿⣿⣿⣿⣖⢀⠀⠀⠀⠀⠀⠀⠀⠀⢀⢀⢀⢀⢀⢀⠀⠀⠀⠀⠀⠀⠀⢠⣾⣿⣿⣿⠀⠀⠀⠀⠀⢈⣿⣿⣿⣿
⣿⣿⣿⣿⣿⣿⣿⣿⣿⣿⣿⣿⣿⣿⣷⣶⣶⣶⣶⣶⣶⣶⣿⣿⣿⣿⣿⣿⣷⣶⣶⣶⣶⣶⣶⣿⣿⣿⣿⠋⠀⠀⠀⠀⠀⠀⢸⣿⣿⣿
⣿⣿⣿⣿⣿⣿⣿⣿⡟⠀⠙⢿⣿⣿⣿⣿⣿⣿⣿⣿⣿⣿⣿⣿⢟⠋⠋⢿⣿⣿⣿⣿⣿⣿⣿⣿⣿⢟⠋⠀⠀⠀⠀⠀⠀⠀⢨⣿⣿⣿
⣿⣿⣿⣿⣿⣿⣿⣿⠀⠀⠀⠀⠉⠉⠉⠁⠀⠀⠀⠀⠀⠀⠀⠀⠀⠀⠀⠀⠀⠀⠀⠀⠀⠀⠀⠀⠀⠀⠀⠀⠀⠀⠀⠀⠀⢠⣿⣿⣿⣿
⣿⣿⠟⠟⠟⠏⠁⠁⠀⠀⠀⠀⠀⠀⠀⠀⠀⠀⠀⠀⠀⠀⠀⠀⠀⠀⠀⠀⠀⠀⠀⠀⠀⠀⠀⠀⠀⠀⠀⠀⠀⠀⠀⠀⠀⢨⣿⣿⣿⣿
⠀⠀⠀⠀⠀⠀⠀⠀⠀⠀⠀⠀⠀⠀⠀⠀⠀⠀⠀⠀⠀⠀⠀⢀⢀⢀⢀⢀⢀⢀⢀⢀⣦⣦⣶⠀⠀⠀⠀⢀⢀⢀⣤⣦⣦⣿⣿⣿⣿⣿
⠀⠀⠀⠀⠀⠀⠀⠀⠀⠀⠀⢀⣀⣦⣶⣶⣦⣦⣀⣦⣶⣶⣶⣿⣿⣿⣿⣿⣿⣿⣿⣿⣿⣿⣿⣦⣶⣶⣶⣿⣿⣿⣿⣿⣿⣿⣿⣿⣿⣿
⣄⣄⣄⣄⣄⣤⣦⣷⣷⣷⣷⣿⣿⣿⣿⣿⣿⣿⣿⣿⣿⣿⣿⣿⣿⣿⣿⣿⣿⣿⣿⣿⣿⣿⣿⣿⣿⣿⣿⣿⣿⣿⣿⣿⣿⣿⣿⣿⣿⣿
⠿⠿⠿⠿⠿⠿⠿⠿⠿⠿⠿⠿⠿⠿⠿⠿⠿⠿⠿⠿⠿⠿⠿⠿⠿⠿⠿⠿⠿⠿⠿⠿⠿⠿⠿⠿⠿⠿⠿⠿⠿⠿⠿⠿⠿⠿⠿⠿⠿
0
20