⠀⠀⠀⠀⠀⠀⠀⠀⠀⠀⠀⠀⠀⢀⣀⣴⣦⣶⣾⣿⣿⣿⣿⣿⣿⣿⣿⣿⣿⣿⣿⣿⣿⣿⣿⣿⣷⣦⣦⣀⣀⣀⣼⣿⣿⣿⠀⠀⠀⠀
⠀⠀⠀⠀⢠⣦⣾⣷⣷⣷⣦⣦⣾⣿⣿⣿⣿⣿⣿⣿⢟⠋⠉⠉⠉⠉⠉⠉⠉⠉⠉⠉⠉⠙⢻⢿⣿⣿⣿⣿⣿⣿⣿⣿⣿⢏⠀⠀⠀⠀
⣠⣦⣿⣿⣿⣿⣿⣿⣿⣿⣿⣿⣿⣿⢿⠏⠉⠁⠀⠀⠀⠀⠀⠀⠀⠀⠀⠀⠀⠀⠀⠀⠀⠀⠀⠀⠈⠉⠉⠉⠉⠉⠉⠉⠁⠀⠀⠀⠀⠀
⣿⣿⣿⣿⣿⣿⣿⣿⣿⣯⣅⠉⠁⠀⠀⠀⢀⣠⣤⣄⠀⠀⠀⠀⠀⠀⠀⠀⠀⠀⠀⠀⠀⠀⠀⠀⠀⠀⠀⠀⠀⠀⠀⠀⠀⢀⣠⣤⣤⣤
⣿⣿⣿⣿⣿⣿⣿⣿⣿⣿⣿⣧⣄⠀⠀⢠⣾⣿⣿⣿⠀⠀⢀⢀⣠⣦⣦⣦⣦⣦⣦⣦⣦⣦⣦⣦⣄⠀⠀⠀⠀⠀⠀⢠⣾⣿⣿⣿⣿⣿
⣿⣿⣿⣿⣿⣿⠀⠀⠋⢻⣿⣿⣿⠀⠀⠈⢿⣿⣿⣿⣦⣶⣿⣿⣿⣿⣿⣿⣿⣿⣿⣿⣿⣿⣿⣿⢟⠀⠀⠀⠀⠀⠀⢸⣿⣿⣿⣿⣿⣿
⣿⣿⣿⢟⠉⠀⠀⠀⠀⠀⠉⠉⠉⠀⠀⠀⢨⣿⣿⣿⣿⣿⣿⢟⠋⠉⠉⠀⠀⠀⠀⠀⠀⠀⠀⠀⠀⠀⠀⠀⠀⠀⠀⠀⠙⢻⣿⣿⣿⣿
⣿⣿⠀⠀⠀⠀⠀⢠⣤⣤⣤⣤⣤⣤⣠⣠⣿⣿⣿⣿⠏⠉⠁⠀⠀⠀⠀⠀⠀⠀⠀⠀⠀⠀⠀⠀⠀⠀⠀⠀⠀⠀⠀⠀⠀⢸⣿⣿⣿⣿
⣿⣿⠀⠀⠀⠀⢀⣿⣿⣿⣿⣿⣿⣿⣿⣿⣿⣿⠏⠁⠀⠀⠀⠀⠀⠀⠀⠀⠀⠀⠀⠀⠀⠀⠀⠀⠀⠀⢀⣮⣿⣷⠀⠀⠀⠀⢫⣿⣿⣿
⣿⣿⠀⠀⠀⠀⠀⠀⠀⠀⠀⠈⣫⣿⣿⣿⣿⠋⠀⠀⠀⠀⠀⢀⣠⣦⣾⣿⣿⣿⣿⣿⣧⠀⠀⠀⠀⠀⢸⣿⣿⣿⠀⠀⠀⠀⢸⣿⣿⣿
⣿⣿⣦⠀⠀⠀⠀⠀⠀⠀⢀⣼⣿⣿⣿⣟⠀⠀⠀⠀⢀⣴⣦⣾⣿⣿⣿⣿⣿⣿⣿⣿⣟⠀⠀⠀⠀⠀⢸⣿⣿⣿⠀⠀⠀⠀⢸⣿⣿⣿
⣿⣿⣿⠀⠀⠀⠀⠀⠀⠀⢸⣿⣿⣿⢏⠀⠀⠀⠀⠀⢸⣿⣿⣿⣿⣿⣿⣿⣿⢟⠋⠉⠀⠀⠀⠀⠀⠀⢸⣿⣿⣿⠀⠀⠀⠀⠀⢙⣿⣿
⣿⣿⣿⠀⠀⠀⠀⠀⠀⠀⢸⣿⣿⣿⠀⠀⠀⠀⠀⠀⢸⣿⣿⣿⣿⣿⣿⠏⠁⠀⠀⠀⠀⠀⠀⠀⠀⠀⢸⣿⣿⣿⠀⠀⠀⠀⠀⠀⢻⢿
⣿⣿⣿⠀⠀⠀⠀⠀⠀⠀⢸⣿⣿⣿⠀⠀⠀⠀⠀⠀⢘⣿⣿⣿⠟⠋⠁⠀⠀⠀⠀⠀⠀⠀⠀⠀⠀⣰⣿⣿⣿⠁⠀⠀⠀⠀⠀⠀⠀⠀
⣿⣿⣿⠀⠀⠀⠀⠀⠀⠀⢸⣿⣿⣿⣧⠀⠀⠀⠀⠀⠀⠀⠀⠀⠀⠀⠀⠀⠀⠀⠀⠀⠀⢀⢀⣠⣾⣿⣿⣿⣦⣦⣦⣦⣦⣦⣄⠀⠀⠀
⣿⣿⠀⠀⠀⠀⠀⠀⠀⠀⠀⠋⢻⣿⢟⠀⠀⠀⠀⠀⠀⠀⠀⠀⠀⠀⠀⢀⣀⣀⣴⣦⣶⣾⣿⣿⣿⣿⣿⢻⣿⣿⣿⣿⣿⣿⢟⠀⠀⠀
⣿⣿⠀⠀⠀⠀⠀⠀⠀⠀⠀⠀⠀⠀⠀⠀⠀⠀⠀⠀⠀⠀⢀⣠⣦⣾⣾⣿⣿⣿⣿⣿⣿⣿⣿⣿⣿⣧⣀⠀⠀⠀⠀⠀⠀⠀⠀⠀⠀⠀
⢿⠏⠀⠀⠀⠀⠀⠀⠀⠀⠀⠀⠀⠀⠀⠀⠀⠀⠀⠀⢀⣮⣿⣿⣿⣿⣿⣿⣍⣉⠉⠉⠁⠀⢻⣿⣿⣿⣿⣦⠀⠀⠀⢠⣤⣤⣤⣠⣤⣦
⠀⠀⠀⠀⠀⠀⠀⠀⠀⠀⠀⠀⠀⠀⠀⠀⠀⠀⠀⠀⠀⠋⠟⠟⠻⣿⣿⣿⣿⣿⠀⠀⠀⠀⠀⠈⠋⠟⠟⠋⠀⠀⢀⣿⣿⣿⣿⣿⣿⣿
⠀⠀⠀⠀⠀⠀⠀⠀⠀⠀⠀⠀⠀⠀⠀⠀⠀⠀⠀⠀⠀⠀⠀⠀⠀⠀⠈⢿⣿⣿⠀⠀     ⠀⠀⠀⠀⠀⢀⢀⢈⣫⣿⣿⣿⣿
⠀⠀⠀⠀⠀⠀⠀⠀⠀⠀⠀⠀⠀⠀⠀⠀⠀⠀⠀⢀⣀⣀⣀⣀⣀⣀⣀⣀⣀⣀⣀⣀⣠⣿⣿⣿⣿⣷⣦⣀⣦⣶⣾⣿⣿⣿⣿⣿⣿⣿
⣦⣶⣦⣄⣄⣄⣄⣄⣄⣄⣄⣄⣄⣄⣄⣄⣄⣤⣦⣿⣿⣿⣿⣿⣿⣿⣿⣿⣿⣿⣿⣿⣿⣿⣿⣿⣿⣿⣿⣿⣿⣿⣿⣿⣿⣿⣿⣿⣿⣿
⠿⠿⠿⠿⠿⠿⠿⠿⠿⠿⠿⠿⠿⠿⠿⠿⠿⠿⠿⠿⠿⠻⠛⠿⠿⠿⠿⠿⠿⠿⠿⠿⠿⠿⠿⠿⠿⠿⠿⠿⠿⠿⠿⠿⠿⠿⠿⠿⠿⠿
0
19