⠀⠀⠀⠀⠀⠀⢀⣴⣦⣦⠀⠀⠀⠀⠀⠀⠀⠀⠀⠀⠀⠀⠀⠀⠀⠀⠀⠀⠀⠀⠀⠀⠀⠀⠀⠀⠀⠀⠀⠀⠀⠀⠀⠀⠀⠀⠀⠀⠀⠀
⠀⠀⠀⠀⠀⠀⢸⣿⣿⣿⣀⠀⠀⠀⠀⠀⠀⠀⠀⠀⢀⣠⣀⠀⠀⠀⠀⠀⠀⢠⣦⣾⣷⣷⣷⣷⣦⣄⣤⣦⣾⣷⣦⣀⠀⠀⠀⠀⠀⠀
⠀⠀⠀⠀⠀⠀⢘⣿⣿⣿⣿⣦⣄⠀⠀⠀⠀⠀⠀⢰⣿⣿⣿⣤⣤⣤⣀⠀⢰⣿⣿⣿⣿⢿⣿⣿⣿⣿⣿⣿⣿⣿⣿⣿⣦⠀⠀⠀⠀⠀
⠀⢀⣮⣿⣧⠀⠀⠈⠫⣿⣿⣿⣿⣧⣄⠀⠀⠀⠀⢘⣿⣿⣿⣿⣿⣿⣿⣧⣴⣿⣿⣿⣧⠀⠈⠉⠉⠉⠉⠉⠉⢫⣿⣿⣿⠀⠀⠀⠀⠀
⠀⢸⣿⣿⣿⣧⣦⣄⠀⠀⠋⢿⣿⣿⣿⣄⣀⣀⣀⢀⠀⠀⠀⠈⢫⣿⣿⣿⣿⣿⣿⣿⠋⠀⠀⠀⠀⠀⠀⠀⢠⣾⣿⣿⣿⠀⠀⠀⠀⠀
⠀⠀⠋⢻⣿⣿⣿⣿⣷⠀⠀⠈⢻⣿⣿⣿⣿⣿⣿⣿⣷⣦⠀⠀⢸⣿⣿⣿⠀⠀⠀⠀⠀⢀⣴⣦⣶⣶⣶⣶⣾⣿⣿⣿⢋⠀⠀⠀⠀⠀
⠀⠀⠀⠀⠀⢙⣿⣿⣿⣦⠀⠀⠀⠉⠉⠉⠉⠉⠙⢿⣿⢏⠀⠀⢸⣿⣿⣿⠀⠀⠀⠀⠀⢸⣿⣿⣿⣿⢿⢿⢿⣿⣿⣿⣿⠀⠀⠀⠀⠀
⠀⠀⠀⠀⠀⠀⢉⣿⣿⣿⣧⠀⠀⠀⠀⠀⠀⠀⠀⠀⠀⠀⠀⢐⣿⣿⣿⠏⠀⠀⠀⠀⢀⣮⣿⣿⣿⠀⠀⠀⠀⢸⣿⣿⣿⠀⠀⠀⠀⠀
⠀⠀⠀⠀⠀⠀⠀⢈⣿⣿⣿⣧⠀⢀⣮⣿⣧⠀⠀⠀⠀⠀⠀⠀⠈⠉⠁⠀⠀⠀⠀⠀⢸⣿⣿⣿⠏⠀⠀⠀⢀⣿⣿⣿⣿⠀⠀⠀⠀⠀
⠀⠀⠀⠀⠀⠀⠀⢀⣸⣿⣿⣿⠀⢸⣿⣿⣿⠀⠀⠀⢀⢀⠀⠀⠀⢀⣠⣦⣦⣦⣦⣦⣴⣿⣿⣿⠀⠀⠀⠀⠀⢨⣿⣿⣿⣦⣦⣦⣦⣦
⠀⠀⠀⠀⠀⢀⣀⣠⣿⣿⣿⣟⠀⢸⣿⣿⣿⠀⠀⢠⣾⣿⣷⠀⠀⢸⣿⣿⣿⣿⣿⣿⣿⣿⣿⣿⠀⠀⠀⠀⠀⢸⣿⣿⣿⣿⣿⣿⣿⣿
⠀⠀⢠⣦⣾⣿⣿⣿⣿⣿⢏⠀⠀⢸⣿⣿⣿⠀⠀⢸⣿⣿⣿⣀⠀⠀⠉⠉⠉⠀⠉⠉⠉⠉⠉⠉⠀⠀⠀⠀⠀⠀⠉⠉⠉⠉⠀⠀⠀⠀
⣿⣿⣿⣿⣿⣿⢿⠏⠉⠁⠀⢠⣮⣿⣿⣿⣿⠀⠀⢘⣿⣿⣿⣿⠀⠀⠀⠀⠀⠀⠀⠀⠀⠀⠀⠀⠀⠀⠀⠀⠀⠀⢠⣤⣤⣤⣤⣤⣤⣤
⠟⠟⠟⠟⠋⠁⠀⣠⣮⣿⣿⣿⣿⣿⣿⠏⠁⠀⠀⠀⢨⣿⣿⣿⣄⠀⠀⠀⠀⠀⠀⠀⠀⠀⠀⠀⠀⠀⠀⣠⣤⣴⣿⣿⣿⣿⣿⣿⣿⣿
⠀⠀⠀⠀⠀⠀⢸⣿⣿⣿⠛⠛⠛⠋⠀⠀⠀⠀⠀⠀⢈⢿⣿⣿⣿⣿⣧⣄⠀⠀⠀⠀⠀⠀⠀⠀⠀⠀⢈⢿⣿⣿⣿⣿⣿⣿⠀⠀⠀⠀
⠀⠀⠀⠀⠀⠀⢸⣿⣿⣿⠀⠀⠀⠀⠀⠀⠀⠀⠀⠀⠀⠀⠋⠋⢻⣿⣿⣿⣷⣦⠀⠀⠀⠀⠀⠀⠀⠀⠀⢀⣀⣀⣀⣀⣀⣀⣀⢀⠀⠀
⠀⠀⠀⠀⠀⢠⣿⣿⣿⣿⠀⠀⠀⢀⣠⣄⣄⣠⣀⠀⠀⠀⠀⠀⠀⠈⢻⣿⣿⣿⣄⠀⠀⠀⠀⠀⠀⠀⢠⣿⣿⣿⣿⣿⣿⣿⣿⣿⣷⣦
⠀⠀⠀⠀⠀⠈⢻⣿⣿⣿⠀⠀⢐⣿⣿⣿⣿⣿⣿⠀⠀⠀⠀⠀⠀⠀⢘⣿⣿⣿⣿⣦⣄⠀⠀⠀⠀⠀⠀⠈⠉⠉⠉⠉⠉⢻⣿⣿⣿⠟
⠀⠀⠀⠀⠀⠀⢸⣿⣿⣿⠀⠀⠀⠈⠉⢉⣿⣿⣿⣄⠀⠀⠀⠀⠀⠀⠀⠈⠫⣿⣿⣿⣿⣷⣿⣿⣿⣧⣄⠀⠀⠀⠀⠀⠀⠀⠈⠁⠀⠀
⠀⠀⠀⠀⠀⠀⢸⣿⣿⣿⠀⠀⠀⠀⠀⢈⢿⣿⣿⣿⣿⣿⣧⣄⣀⣀⣀⢀⠀⠀⠋⢿⣿⣿⣿⣿⣿⣿⣿⣄⠀⠀⠀⠀⠀⠀⠀⠀⠀⠀
⠀⠀⠀⠀⠀⠀⢸⣿⣿⣿⣦⣦⣀⠀⠀⠀⠀⠋⠋⠋⢻⣿⣿⣿⣿⣿⣿⣿⣷⣶⣶⣶⣦⣦⢀⠈⢻⣿⣿⢟⠀⠀⠀⠀⠀⠀⠀⠀⠀⠀
⠀⠀⠀⠀⠀⠀⠈⢻⢿⣿⣿⣿⣿⠀⠀⠀⠀⠀⠀⠀⠀⠉⠉⠉⠉⠉⠙⢻⢿⢿⢿⣿⣿⣿⣿⣀⠀⠀⠀⠀⠀⠀⠀⠀⠀⠀⠀⠀⠀⠀
⠀⠀⠀⠀⠀⠀⠀⠀⠚⠛⠿⠿⠋⠀⠀⠀⠀⠀⠀⠀⠀⠀⠀⠀⠀⠀⠀⠀⠀⠀⠀⠈⠛⠿⠿⠛⠀⠀⠀⠀⠀⠀⠀⠀⠀⠀⠀⠀⠀⠀
49
11